county	owl:Thing	PopulatedPlace
mountainRange	Mountain	MountainRange
nextEvent	Event	Event
country	owl:Thing	Country
populationPlace	EthnicGroup	PopulatedPlace
locationCountry	owl:Thing	Country
politicalPartyInLegislature	Legislature	PoliticalParty
placeOfBurial	Person	Place
schoolBoard	School	owl:Thing
isPartOfMilitaryConflict	MilitaryConflict	MilitaryConflict
illustrator	WrittenWork	Person
leaderParty	PopulatedPlace	owl:Thing
district	Place	PopulatedPlace
governor	owl:Thing	Person
hubAirport	Airline	Airport
binomialAuthority	Species	owl:Thing
campus	University	owl:Thing
academicAdvisor	Scientist	Person
industry	Company	owl:Thing
formerTeam	Athlete	SportsTeam
education	Person	owl:Thing
region	owl:Thing	Place
location	owl:Thing	Place
routeJunction	RouteOfTransportation	Station
ethnicGroup	PopulatedPlace	EthnicGroup
showJudge	TelevisionShow	Person
almaMater	Person	EducationalInstitution
doctoralAdvisor	Scientist	Person
associatedBand	owl:Thing	Band
headquarter	Organisation	PopulatedPlace
composer	Work	Person
militaryUnit	MilitaryPerson	MilitaryUnit
party	owl:Thing	PoliticalParty
bronzeMedalist	SportsEvent	Person
nonFictionSubject	WrittenWork	owl:Thing
leftTributary	River	River
bandMember	Band	Person
relative	Person	Person
ethnicity	Person	EthnicGroup
series	owl:Thing	owl:Thing
formerBroadcastNetwork	Broadcaster	BroadcastNetwork
child	Person	Person
producer	Work	Agent
gameEngine	VideoGame	owl:Thing
museum	Artwork	Museum
successor	owl:Thing	owl:Thing
stylisticOrigin	MusicGenre	MusicGenre
board	Person	owl:Thing
governingBody	Place	Organisation
associatedMusicalArtist	owl:Thing	MusicalArtist
channel	owl:Thing	Broadcaster
parentOrganisation	Organisation	Organisation
colour	owl:Thing	Colour
river	Place	River
federalState	Settlement	PopulatedPlace
religion	owl:Thing	owl:Thing
stateOfOrigin	Person	Country
developer	owl:Thing	Agent
founder	owl:Thing	Person
college	Person	EducationalInstitution
outflow	BodyOfWater	River
relation	Person	Person
parentMountainPeak	Mountain	Mountain
distributingCompany	RecordLabel	Company
city	owl:Thing	City
targetAirport	Airline	Airport
programmeFormat	Broadcaster	owl:Thing
currency	owl:Thing	Currency
domain	Species	owl:Thing
servingRailwayLine	Station	owl:Thing
goldMedalist	SportsEvent	Person
province	Place	Province
broadcastNetwork	Broadcaster	BroadcastNetwork
spokenIn	Language	PopulatedPlace
musicalArtist	Single	MusicalArtist
intercommunality	owl:Thing	PopulatedPlace
philosophicalSchool	Person	owl:Thing
managerClub	Athlete	SportsTeam
deathCause	Person	owl:Thing
parent	Person	Person
cinematography	Film	Person
training	Artist	EducationalInstitution
starring	Work	Actor
powerType	MeanOfTransportation	owl:Thing
capital	PopulatedPlace	City
sire	Animal	Animal
lieutenant	owl:Thing	Person
department	PopulatedPlace	Department
mouthPlace	River	PopulatedPlace
author	Work	Person
voice	owl:Thing	Person
portrayer	FictionalCharacter	owl:Thing
picture	owl:Thing	owl:Thing
rival	School	School
locatedInArea	Place	Place
owningOrganisation	owl:Thing	Organisation
license	Work	owl:Thing
lastAppearance	FictionalCharacter	owl:Thing
race	owl:Thing	Race
movement	Artist	owl:Thing
archipelago	Island	owl:Thing
frazioni	Settlement	PopulatedPlace
routeStart	RouteOfTransportation	Station
keyPerson	owl:Thing	Person
chancellor	owl:Thing	Person
leaderName	PopulatedPlace	Person
company	owl:Thing	Organisation
isPartOf	owl:Thing	owl:Thing
instrument	Artist	Instrument
maintainedBy	ArchitecturalStructure	owl:Thing
assembly	MeanOfTransportation	owl:Thing
silverMedalist	SportsEvent	Person
influenced	owl:Thing	owl:Thing
municipality	owl:Thing	PopulatedPlace
president	owl:Thing	Person
creator	owl:Thing	Agent
owningCompany	owl:Thing	Company
presenter	TelevisionShow	Person
trainer	Athlete	Person
bodyStyle	Automobile	owl:Thing
formerCoach	FigureSkater	Person
subsidiary	Company	Company
chairman	owl:Thing	Person
designCompany	owl:Thing	Company
automobilePlatform	Automobile	Automobile
growingGrape	WineRegion	Grape
tenant	ArchitecturalStructure	Organisation
musicBy	Musical	Person
employer	Person	Organisation
musicalBand	Single	Band
lieutenancyArea	PopulatedPlace	PopulatedPlace
currentMember	SportsTeam	Person
album	owl:Thing	Album
editing	Film	Person
musicComposer	Work	MusicalArtist
coach	owl:Thing	Person
recordedIn	MusicalWork	PopulatedPlace
product	Organisation	owl:Thing
cpu	owl:Thing	owl:Thing
regionServed	Organisation	Place
languageFamily	Language	owl:Thing
publisher	Work	Agent
origin	owl:Thing	PopulatedPlace
foundedBy	owl:Thing	Agent
significantProject	Person	owl:Thing
institution	owl:Thing	Organisation
nationality	Person	Country
appointer	owl:Thing	Person
nearestCity	Place	PopulatedPlace
riverMouth	River	BodyOfWater
phylum	Species	owl:Thing
sourcePlace	owl:Thing	PopulatedPlace
related	owl:Thing	owl:Thing
relatedMeanOfTransportation	MeanOfTransportation	MeanOfTransportation
monarch	owl:Thing	Person
debutTeam	Athlete	SportsTeam
secondLeader	owl:Thing	Person
breeder	Animal	Person
mouthMountain	River	Mountain
governmentType	owl:Thing	GovernmentType
computingPlatform	Software	owl:Thing
draftTeam	Athlete	SportsTeam
service	Organisation	owl:Thing
leader	owl:Thing	Person
kingdom	Species	owl:Thing
canton	Settlement	Settlement
field	Artist	owl:Thing
commandStructure	MilitaryUnit	MilitaryUnit
spouse	Person	Person
manager	SportsTeam	Person
militaryRank	MilitaryPerson	owl:Thing
executiveProducer	owl:Thing	Person
grandsire	Animal	Animal
firstLeader	owl:Thing	Person
affiliation	owl:Thing	Organisation
state	owl:Thing	PopulatedPlace
webcast	owl:Thing	owl:Thing
class	owl:Thing	owl:Thing
ideology	Agent	Ideology
principalArea	PopulatedPlace	PopulatedPlace
genus	Species	owl:Thing
sourceMountain	owl:Thing	Mountain
programmingLanguage	Software	owl:Thing
division	owl:Thing	owl:Thing
magazine	WrittenWork	Magazine
operatingSystem	Software	owl:Thing
language	owl:Thing	Language
formerPartner	FigureSkater	Person
predecessor	owl:Thing	owl:Thing
rightTributary	River	River
raceHorse	owl:Thing	Horse
coverArtist	Work	Person
locationCity	Organisation	City
damsire	Animal	Animal
owner	owl:Thing	Agent
parentCompany	owl:Thing	Company
distributingLabel	RecordLabel	RecordLabel
genre	owl:Thing	Genre
ceremonialCounty	PopulatedPlace	PopulatedPlace
formerBandMember	Band	Person
guest	TelevisionEpisode	Person
partner	Person	Person
ground	SoccerClub	Place
species	Species	Species
architecturalStyle	ArchitecturalStructure	owl:Thing
subsequentWork	Work	Work
profession	Person	owl:Thing
athletics	University	owl:Thing
league	owl:Thing	SportsLeague
doctoralStudent	Scientist	Person
network	Broadcaster	Broadcaster
primeMinister	owl:Thing	Person
artist	MusicalWork	Agent
stadium	owl:Thing	Stadium
previousWork	Work	Work
routeEnd	RouteOfTransportation	Station
daylightSavingTimeZone	Place	owl:Thing
homeStadium	owl:Thing	Stadium
garrison	MilitaryUnit	PopulatedPlace
narrator	Work	Person
broadcastArea	Broadcaster	PopulatedPlace
writer	Work	Person
militaryBranch	MilitaryPerson	MilitaryUnit
operator	owl:Thing	owl:Thing
recordLabel	owl:Thing	RecordLabel
director	Film	Person
majorShrine	Saint	owl:Thing
award	owl:Thing	Award
territory   AdministrativeRegion	PopulatedPlace
manufacturer	owl:Thing	Organisation
position	owl:Thing	owl:Thing
openingTheme	TelevisionShow	Work
nationalAffiliation	PoliticalParty	owl:Thing
localAuthority	owl:Thing	owl:Thing
lyrics	MusicalWork	Person
season	Agent	owl:Thing
arrondissement	PopulatedPlace	PopulatedPlace
notableCommander	MilitaryUnit	Person
basedOn	Work	Work
part	owl:Thing	owl:Thing
commander	owl:Thing	Person
source	owl:Thing	owl:Thing
university	owl:Thing	EducationalInstitution
leaderFunction	Organisation	PersonFunction
significantBuilding	Architect	Building
place	MilitaryConflict	PopulatedPlace
citizenship	Person	owl:Thing
usedInWar	Weapon	MilitaryConflict
variantOf	owl:Thing	owl:Thing
saint	PopulatedPlace	Saint
jurisdiction	owl:Thing	owl:Thing
deathPlace	Person	Place
distributor	owl:Thing	Organisation
mediaType	WrittenWork	owl:Thing
battle	owl:Thing	MilitaryConflict
influencedBy	owl:Thing	owl:Thing
countySeat	PopulatedPlace	owl:Thing
neighboringMunicipality	PopulatedPlace	PopulatedPlace
knownFor	owl:Thing	owl:Thing
metropolitanBorough	PopulatedPlace	PopulatedPlace
ingredient	Food	owl:Thing
type	owl:Thing	owl:Thing
inflow	BodyOfWater	BodyOfWater
builder	owl:Thing	owl:Thing
councilArea	PopulatedPlace	PopulatedPlace
previousEvent	Event	Event
notableStudent	Scientist	Person
aircraftFighter	MilitaryUnit	MeanOfTransportation
format	owl:Thing	owl:Thing
deputy	owl:Thing	Person
designer	owl:Thing	Person
person	PersonFunction	Person
railwayRollingStock	RouteOfTransportation	owl:Thing
honours	owl:Thing	owl:Thing
otherParty	OfficeHolder	PoliticalParty
restingPlace	Person	Place
architect	ArchitecturalStructure	Architect
mainInterest	owl:Thing	owl:Thing
animator	Cartoon	Agent
internationalAffiliation	PoliticalParty	owl:Thing
foundationPlace	Organisation	City
notableWork	owl:Thing	Work
sport	owl:Thing	Sport
followingEvent	Event	Event
sisterStation	Broadcaster	Broadcaster
residence	Person	Place
sourceCountry	Stream	Country
birthPlace	Person	Place
associate	owl:Thing	Person
editor	owl:Thing	Agent
billed	Wrestler	PopulatedPlace
largestCity	PopulatedPlace	PopulatedPlace
timeZone	Place	owl:Thing
hometown	Agent	Settlement